S L F A L T T T
L L F A A T A F
L A A A T T H T
D A L L F T A T
A L A L A L D F
G L L A H F L H
F L F F F A F L
A F L F F T L A
