S A L A T L L L
A A H F A G A A
H G L A H L T T
G F T F T L L A
L L L A T F D T
T T T G L H L T
F L F T L T G T
A A L L F F T D
