S A A A T D T T
L A L G L A A L
T L G L F L F L
L F F D A T A T
T F L T F L L A
L L T A G T A H
L A A H G F T A
T A H H L T L F
