S L L T H H A A
H L L L F A L F
L H G A F A A T
D L T T L H T A
L A L H F H F H
L T A F H F F A
H F D T L G A F
A F A F A T H G
