S F T T L G T L
H F T A L T F L
F T T L L L A H
H A F H F D F T
L A T A T T L T
T G A F A H F T
A H L T T F A L
G T F D T L L A
