S T L F A F L F
A T F T T L H T
A T T G A H T A
H G A A T A G T
T H F T L L A T
A A A F A D T G
T H D G A L T A
F F T L T F A T
