S T F L A T D F
L L F T T A L A
A H T A F A F F
L G H D F F F T
T G L A A T A T
T A T G A F A A
H A A T T G T F
L A A A A L T F
