S F A H H H G L
L T H A T H A T
T F F T G H A A
T H A A L G D F
A L H T L L A F
L A H F H D T L
T A A T H L H H
T L L A A H L T
