S L L G L F L T
L D T F F T L A
L A T D L A H H
A A A T L T T T
F T A T F A T L
A F A H T A A L
F L F L T L L T
G L H T A T A L
