S T L T T H L T
H T A T L T G A
T F L G L L T G
G T H L F L T T
F G H L D L T L
H L A L H A L H
H A T A A F H T
T T F F T D L F
