S D F H A A H T
H T T F T H F H
G H L L A L T A
F H T T D H G F
F H G T F H F L
H T H T F F A L
L L T H H A H H
H A F A L H H L
