S L L F A L L T
F F A A A F L A
L T L F H T A L
D L T T A L H T
A A L T L G T D
A T A F T H T A
T T G F G L H G
L H A T T L A H
