S A L F F L A L
A H D A A A F L
F F F F F T F A
A L L F A T A A
L T A T A T F L
D L T G A F L L
A F F F T T L A
A G T F F L F L
