S L F T L L F T
F T L L T T F A
L T F D T T F L
H A T L T H L F
T F A T A A H T
A F T L D A L T
T F T F A L F T
G F T H L A F F
