S T H L F H A F
H L T H T T G H
D F A H H F T F
T L G L F T H T
T F F T F L F G
H F A H L G D T
T A T L H F F A
H F H L H H A F
