S F A T T A L A
T F A A F T T A
L A F F T L F T
L L T L T G A A
L L L T L T F D
F F A F D T L T
L A L T F A A A
L L T L L A A T
