S A F L A F G T
A A F L F H A F
T D H A F A A L
H A F F G F A A
T T G L A G L F
A D L F L T F A
L T L F T A T T
T F T F G L F L
