S T H T F L F A
H D H H A L A A
L F L A L H A T
A H L G F F A T
G T A A T L A T
A A T F H A G A
D A F A F L A T
H T A L A A A H
