S H A L F L T T
F F G T G G F L
T T T F F A L H
F A L H L L L L
T L F H T H F T
A L T T T F A L
A H L A T L D H
D A T G G F F A
