S H F F F H L T
L F F G A T T H
T T F L H F A G
L H F G T L L T
T F F D F L H L
H A L T H L T L
F D T A L G L H
L A A A H A G F
