S F G A T H G T
G F A H A L A L
H H H T F A G A
F L L L T A F A
H G F L A T D T
T H L F A H L A
D L T L T F A L
A L A H H F F T
