S H L D L F L A
L L T T L A A L
G G F L F F T F
F G F T A T H H
F H D F A T H H
F L A A A T A F
F T F H T A H L
T A H F L F T H
