S T L H A H H A
T D T H T H A H
A F L A T H D F
G H L T A F T F
F T F H T L H T
L A H H T A H H
A T T L H H L H
A G F F L L H G
