S A L A G T G F
F T G L T T T A
L A A F A T F F
L D L L L T F A
L F T A T G D T
T A A A H T T A
H A L T F L A L
T F T T T F H H
