S A A F T F H T
A L A H F T L L
F L A T T F G F
H H L L H G L L
L T H F T F L H
H H H H H A F L
T G A L L H D F
A T D A F A F A
