S F A A G D L L
F G D L H L L A
T L T H G G F A
H H L T L H F A
F A F F L H L T
F L T T T L A L
L T A L L A T F
T L H L A T A F
