S H A G H L F L
T A A L A F A H
L F T H L T T F
H H T H T A A A
H T H D A H F L
H A T G L T G L
H F A T T G T T
F T A D A A H A
