S T G H F L A F
F H H F H L T A
L A T A T F H F
H F D H H H F H
A T H T F A L F
L G H F L A H F
L H L L F L H F
A L A H A D F H
