S A T H T G A L
T L A A T F A L
A A F T D H A T
F L F T F L F A
F T G G T F H L
F F A T L T F A
T F D A T T A A
T F L A H G T L
