S L L F T L H H
F L T F D G L T
F F G T G L A H
T G T L F A A G
D H T T A T H F
L L L H A H T T
H A H T F L L H
L L F F T T T T
