S L A T L A T T
F F H T H H H F
F H L A A T H T
H A F T H A F H
L H A F A D H L
L F F L L T T F
T F T F H T L H
A T G H D T L A
