S H H T L T F L
A T H H A L A A
H T F L H T L T
D A A A A D A F
L H G L T H H A
H H H L G T L T
A F T A L T H L
F H T T L G A F
