S L L H F A T L
F A A A F D T A
A F F F T G T D
A F F H L F T T
F A L G A G A T
H L A L T G A T
G L A F L L L L
L F L A A L T T
