S D H T A A T A
F L L A G T A G
T F T T F A F A
L F F A A A A H
L F T F L T F A
L F T L T L A L
A L D H L T F A
A A A L L T G T
