S L F A A G F T
T A A T F A F H
A H H F F L A H
D A L F A F F A
A T A T A L L T
H L H A T F A D
A H F F F L H F
A H A F L L H F
