S A H T A F T T
T A A A F T F F
T A L A T T H F
A T A F L F L T
T A A F A H H F
H T T D A F T F
D L T F F L F A
T T G A L T H T
