S L A H A H F F
G G L H H F T D
A A F H A H H H
L A L D L F H L
L L T F A F F H
T G T H T H T F
A L L T A H L A
H H T T A H L H
