S T H F H H L T
F F H G L L A A
L G T L A D A D
T F A T G T L T
L A H L H T A A
L A A L F L A L
F T T A L T A L
F F L H L L H H
