S H L G H T T T
H A F F F F A F
D F A F F T H A
H A L T L G A A
H G F T H A L G
T T T L F L T F
T A L T F D L A
F F L F A L A H
