S L F D L T H T
H L H F L H A H
A T T F A H G A
L F H L H T A A
H H L A L A T H
L A D A H A A T
H L F H A H H T
L F L A F F A L
