S F L T T F F T
H F T H F D L G
F F T A T L L L
A T G A F F L A
A T L L F L D F
T L A T A F A F
L T A G T A A L
F L L L A L L F
