S F A T L F F A
A L H G A F D H
A T L A L A F T
F T L H L F F T
H T A F H F T H
T T T H A F F H
D H A T T G T H
L A F F A G T T
