S F D L F G A A
F T A F T F F A
F T D T T A T T
F T T F F L T A
F T A L A F F L
F F A A G L F T
L F L F A L L L
F T F A G L F T
