S T A H A T L A
A H A L T F T A
G F D L T L H D
G T T H L A T A
A A G L A F L L
L T A H L L T H
F L F T A T T A
T A G A A L F L
