S L T T L D H F
T T A L L L L A
L A T T L T H G
H G A L D L F A
H H L A G F L T
H T F A L F T F
A L T T G F G L
A F H L A F L A
