S F F L A H T T
L T F L T T L G
A F L F A L G F
F T A L T A A H
L H T H F D L H
A F L T H D T A
T A G H F A T L
A H H A H L T L
