S A A H F T F T
H L A L A H D A
G H H L D G A L
H L T L L L L H
L F A F T L G A
A T F T H A T L
L T A L F F G F
H F L L A G A A
