S T F L G L F A
L F T D H A F G
L A F F H F T L
T T A F F T A F
L A A A L F T L
T A F F F H F L
F L H T T A A L
L D A F T A A F
