S F L H A H T F
F H F H H T T A
L F D H A H H T
L L L L A H H A
T A D L F A L L
G H H L H F T T
G A H A T F L H
H L L H L T A A
