S H A H L H D L
A F A T T L T H
H A A F H L H L
H T L L G F H T
T A D L H A H F
H H L A T H H T
T L H T A A T A
A L F T L H L T
